[
    {
        "x": 98,
        "y": 44,
        "dim": 60
    },
    {
        "x": 32,
        "y": 208,
        "dim": 64
    },
    {
        "x": 216,
        "y": 328,
        "dim": 64
    },
    {
        "x": 340,
        "y": 232,
        "dim": 64
    },
    {
        "x": 462,
        "y": 390,
        "dim": 64
    },
    {
        "x": 768,
        "y": 328,
        "dim": 64
    },
    {
        "x": 706,
        "y": 172,
        "dim": 64
    }
]
